AAAAAAAAA100011000010001001100110AAAAAAAA
AAAAAAAAA010001111001100010111101AAAAAAAA
AAAAAAAAA011011100101011100101011AAAAAAAA
AAAAAAAAA011000010111111010100100AAAAAAAA
AAAAAAAAA000101011001101111110101AAAAAAAA
AAAAAAAAA001010001000100011111110AAAAAAAA
AAAAAAAAA010101010101010101010101AAAAAAAA
AAAAAAAAA010100110101101000111101AAAAAAAA
AAAAAAAAA110000111001110100110011AAAAAAAA
11100100010111011100111100101010111001101
00111110111010101111110010000101000111110
11011101100001101000101001110010000010101
11010010011001000100100011110101111001010
10100100100110001110000100000101100101010
10101111001001XXXXXXXXXXXXX00010101011001
01001100100001XXXXXXXXXXXXX10101101100001
00110010010100XXXXXXXXXXXXX00100100101010
11111100010001XXXXXXXXXXXXX01100101100011
10000110110100XXXXXXXXXXXXX00100010011111
00001000111001XXXXXXXXXXXXX10101010101011
01100110111101XXXXXXXXXXXXX01000011100110
01001000011111XXXXXXXXXXXXX01110111000011
00101011111111XXXXXXXXXXXXX00101011001110
01101101010100XXXXXXXXXXXXX01010011001111
10100110010000XXXXXXXXXXXXX11101111000000
00011101010100XXXXXXXXXXXXX00111010001010
11010110101110XXXXXXXXXXXXX01100101100011
00100101001011000000101100101100111100001
10001110100111111001110100011100100000011
01101100011100101010000010001000011101011
10111011000000000111100110000010000101011
00101100100111111000101010010110110011010
10001011011100010100110010011001ZZZZZ0110
AAAAAAAAA10011000001110010101110ZZZZZ0011
AAAAAAAAA01011110001010101100000ZZZZZ1110
AAAAAAAAA01110000111011111000010ZZZZZ0100
AAAAAAAAA01100011000111010101110ZZZZZ1001
AAAAAAAAA00011100011011101000101111011100
AAAAAAAAA10010010110101011100000100011001
AAAAAAAAA11110000111011100010111110100010
AAAAAAAAA10111011010001111010110111111010