AAAAAAAAA011100111101110110011001AAAAAAAA
AAAAAAAAA101110000110011101000010AAAAAAAA
AAAAAAAAA100100011010100011010100AAAAAAAA
AAAAAAAAA100111101000000101011011AAAAAAAA
AAAAAAAAA111010100110010000001010AAAAAAAA
AAAAAAAAA110101110111011100000001AAAAAAAA
AAAAAAAAA101010101010101010101010AAAAAAAA
AAAAAAAAA101011001010010111000010AAAAAAAA
AAAAAAAAA001111000110001011001100AAAAAAAA
00011011101000100011000011010101000110010
11000001000101010000001101111010111000001
00100010011110010111010110001101111101010
00101101100110111011011100001010000110101
01011011011001110001111011111010011010101
01010000110110XXXXXXXXXXXXX11101010100110
10110011011110XXXXXXXXXXXXX01010010011110
11001101101011XXXXXXXXXXXXX11011011010101
00000011101110XXXXXXXXXXXXX10011010011100
01111001001011XXXXXXXXXXXXX11011101100000
11110111000110XXXXXXXXXXXXX01010101010100
10011001000010XXXXXXXXXXXXX10111100011001
10110111100000XXXXXXXXXXXXX10001000111100
11010100000000XXXXXXXXXXXXX11010100110001
10010010101011XXXXXXXXXXXXX10101100110000
01011001101111XXXXXXXXXXXXX00010000111111
11100010101011XXXXXXXXXXXXX11000101110101
00101001010001XXXXXXXXXXXXX10011010011100
11011010110100111111010011010011000011110
01110001011000000110001011100011011111100
10010011100011010101111101110111100010100
01000100111111111000011001111101111010100
11010011011000000111010101101001001100101
01110100100011101011001101100110ZZZZZ1001
AAAAAAAAA01100111110001101010001ZZZZZ1100
AAAAAAAAA10100001110101010011111ZZZZZ0001
AAAAAAAAA10001111000100000111101ZZZZZ1011
AAAAAAAAA10011100111000101010001ZZZZZ0110
AAAAAAAAA11100011100100010111010000100011
AAAAAAAAA01101101001010100011111011100110
AAAAAAAAA00001111000100011101000001011101
AAAAAAAAA01000100101110000101001000000101
