11111110110001100001000100110011001111111
10000010101000111100110001011110101000001
10111010001101110010101110010101101011101
10111010101100001011111101010010001011101
10111010100010101100110111111010101011101
10000010100101000100010001111111001000001
11111110101010101010101010101010101111111
00000000001010011010110100011110100000000
00010010011000011100111010011001100111011
11100100010111011100111100101010111001101
00111110111010101111110010000101000111110
11011101100001101000101001110010000010101
11010010011001000100100011110101111001010
10100100100110001110000100000101100101010
10101111001001XXXXXXXXXXXXX00010101011001
01001100100001XXXXXXXXXXXXX10101101100001
00110010010100XXXXXXXXXXXXX00100100101010
11111100010001XXXXXXXXXXXXX01100101100011
10000110110100XXXXXXXXXXXXX00100010011111
00001000111001XXXXXXXXXXXXX10101010101011
01100110111101XXXXXXXXXXXXX01000011100110
01001000011111XXXXXXXXXXXXX01110111000011
00101011111111XXXXXXXXXXXXX00101011001110
01101101010100XXXXXXXXXXXXX01010011001111
10100110010000XXXXXXXXXXXXX11101111000000
00011101010100XXXXXXXXXXXXX00111010001010
11010110101110XXXXXXXXXXXXX01100101100011
00100101001011000000101100101100111100001
10001110100111111001110100011100100000011
01101100011100101010000010001000011101011
10111011000000000111100110000010000101011
00101100100111111000101010010110110011010
10001011011100010100110010011001111110110
00000000110011000001110010101110100010011
11111110001011110001010101100000101011110
10000010001110000111011111000010100010100
10111010001100011000111010101110111111001
10111010100011100011011101000101111011100
10111010010010010110101011100000100011001
10000010011110000111011100010111110100010
11111110010111011010001111010110111111010