AAAAAAAAA100011000010001001100110AAAAAAAA
AAAAAAAAA010001111001100010111101AAAAAAAA
AAAAAAAAA011011100101011100101011AAAAAAAA
AAAAAAAAA011000010111111010100100AAAAAAAA
AAAAAAAAA000101011001101111110101AAAAAAAA
AAAAAAAAA001010001000100011111110AAAAAAAA
AAAAAAAAAUUUUUUUUUUUUUUUUUUUUUUUUAAAAAAAA
AAAAAAAAA010100110101101000111101AAAAAAAA
AAAAAAAAA110000111001110100110011AAAAAAAA
111001T0010111011100111100101010111001101
001111T0111010101111110010000101000111110
110111T1100001101000101001110010000010101
110100T0011001000100100011110101111001010
101001T0100110001110000100000101100101010
101011T1001001XXXXXXXXXXXXX00010101011001
010011T0100001XXXXXXXXXXXXX10101101100001
001100T0010100XXXXXXXXXXXXX00100100101010
111111T0010001XXXXXXXXXXXXX01100101100011
100001T0110100XXXXXXXXXXXXX00100010011111
000010T0111001XXXXXXXXXXXXX10101010101011
011001T0111101XXXXXXXXXXXXX01000011100110
010010T0011111XXXXXXXXXXXXX01110111000011
001010T1111111XXXXXXXXXXXXX00101011001110
011011T1010100XXXXXXXXXXXXX01010011001111
101001T0010000XXXXXXXXXXXXX11101111000000
000111T1010100XXXXXXXXXXXXX00111010001010
110101T0101110XXXXXXXXXXXXX01100101100011
001001T1001011000000101100101100111100001
100011T0100111111001110100011100100000011
011011T0011100101010000010001000011101011
101110T1000000000111100110000010000101011
001011T0100111111000101010010110110011010
100010T1011100010100110010011001ZZZZZ0110
AAAAAAAAA10011000001110010101110ZZZZZ0011
AAAAAAAAA01011110001010101100000ZZZZZ1110
AAAAAAAAA01110000111011111000010ZZZZZ0100
AAAAAAAAA01100011000111010101110ZZZZZ1001
AAAAAAAAA00011100011011101000101111011100
AAAAAAAAA10010010110101011100000100011001
AAAAAAAAA11110000111011100010111110100010
AAAAAAAAA10111011010001111010110111111010